C 251,1,25
WE ./textures/cream_wall.xpm

EA ./textures/red_wall.xpm


NO ./textures/blue_wall.xpm



SO ./textures/green_wall.xpm











F 220,200,10








 1111111111111
100S00P1111111
 1111111111111
