












NO ./path



SO ./path

WE ./path

EA ./path

F   255  ,   193  ,   5
C         148,        55,   100

           1111111 11111111111111
           1111111111111111111111
           1111111111111111111111
111111111111000000000000000000001
100000000000001000000111111111111
1000000000001110000001
1N00000000001100000001
1000000000001000000001
1111111111111111111111






