




NO ./textures/blue_wall.xpm



SO ./textures/green_wall.xpm



WE ./textures/cream_wall.xpm




EA ./textures/red_wall.xpm



F 220,200,10






C 251,1,25




        1111111111111111111111111
        1000000000110000000000001
        1011000001110000000000001
        100100000000000000N000001
111111111011000001110000000000001
100000000011000001110111111111111
11110111111111011100000010001
11110111111111011101010010001
11000000110101011100000010001
10000000001 10001100000010001
10000000000100001101010010001
1100000111010101111101111000111
11110111 1110101 101111010001
11111111 1111111 111111111111
